25 50 150
#########################
#########################
#########################
###.......#####.......###
###.......#####.......###
###.......#####.......###
###...................###
###.......#####.......###
###.......#####.......###
###...................###
######.###########.######
######.###########.######
######.###########.######
###.......#####.......###
###.......#####.......###
###.......#####.......###
###.......#####.......###
###.......#####.......###
###.......#####.......###
###.......#####.......###
######.###########.######
#########################
#########################
#########################
#########################
2 4
2
6 6 4 20
6 18 10 18
2
9 16 20 4
20 10 4 10
