61 50 50
#############################################################
#############################################################
###.......#####.......#####.......#####.......#####.......###
###.......#####.......#####.......#####.......#####.......###
###.......#####.......#####.......#####.......#####.......###
###.........................................................#
###.......#####.......#####.......#####.......#####.......###
###.......#####.......#####.......#####.......#####.......###
###.......#####.......#####.......#####.......#####.......###
######.###########.###########.###########.###########.######
######.###########.###########.###########.###########.######
######.###########.###########.###########.###########.######
######.###########.###########.###########.###########.######
######.###########.###########.###########.###########.######
###.......#####.......#####.......#####.......#####.......###
###.......#####.......#####.......#####.......#####.......###
###.......#####.......#####.......#####.......#####.......###
###.........................................................#
###.......#####.......#####.......#####.......#####.......###
###.......#####.......#####.......#####.......#####.......###
###.......#####.......#####.......#####.......#####.......###
######.###########.###########.###########.###########.######
######.###########.###########.###########.###########.######
######.###########.###########.###########.###########.######
######.###########.###########.###########.###########.######
######.###########.###########.###########.###########.######
###.......#####.......#####.......#####.......#####.......###
###.......#####.......#####.......#####.......#####.......###
###.......#####.......#####.......#####.......#####.......###
###.........................................................#
###.......#####.......#####.......#####.......#####.......###
###.......#####.......#####.......#####.......#####.......###
###.......#####.......#####.......#####.......#####.......###
######.###########.###########.###########.###########.######
######.###########.###########.###########.###########.######
######.###########.###########.###########.###########.######
######.###########.###########.###########.###########.######
######.###########.###########.###########.###########.######
###.......#####.......#####.......#####.......#####.......###
###.......#####.......#####.......#####.......#####.......###
###.......#####.......#####.......#####.......#####.......###
###.........................................................#
###.......#####.......#####.......#####.......#####.......###
###.......#####.......#####.......#####.......#####.......###
###.......#####.......#####.......#####.......#####.......###
######.###########.###########.###########.###########.######
######.###########.###########.###########.###########.######
######.###########.###########.###########.###########.######
######.###########.###########.###########.###########.######
######.###########.###########.###########.###########.######
###.......#####.......#####.......#####.......#####.......###
###.......#####.......#####.......#####.......#####.......###
###.......#####.......#####.......#####.......#####.......###
###.........................................................#
###.......#####.......#####.......#####.......#####.......###
###.......#####.......#####.......#####.......#####.......###
###.......#####.......#####.......#####.......#####.......###
######.###########.###########.###########.###########.######
######.###########.###########.###########.###########.######
######.###########.###########.###########.###########.######
#############################################################
3 4
1
19 6 8 7
2
43 17 28 21
29 31 40 44
1
58 58 20 30
