32 500 500
................................
................................
................................
................................
................................
................................
................................
................................
..............C.................
..............#.................
.............###................
............#####...............
...........#######..............
..........##1###2##.............
.........###########............
........##3######4###...........
.......###############..........
......#################.........
.....###################........
....#####################.......
.............###................
.............###................
.............###................
................................
................................
................................
................................
................................
................................
................................
................................
................................
1 1
1
1 1 22 28